#########
#S     E#
# ### ###
#   #   #
### # ###
#       #
#########
