####################
# #   # # #        #
#   #      ### ### #
## #  ## # #   #   #
# # # # #   # #  # #
#   # #   #    # # #
#B#    # #  # #  # #
## ## ##### #  ## ##
#  # # # #  ##     #
##         #   # # #
# # # # # #  #  #  #
# ##   #   ##  ## ##
#  # # # # # #   # #
##   ##  # # # #   #
### #   #  # ## # ##
##   # # #       ###
#  #A# #   # ## # ##
# # # #  ###   #   #
# #     #    #   # #
####################
