#################
#A  #      #    #
# # # ### # ### #
# #   #   #   #T#
### ### # ##### #
#     # #       #
##### # ####### #
#     #    #   B#
# ##### ### # ###
# #     #   #   #
# # ########### #
#T# #         # #
# # # ####### # #
#   #       # # #
#################