####################
# #   # # #      P #
#   #      ### ###P#
##P#  ## # # P #   #
# # # # #   # #  # #
#   # #T  #    # # #
#E#    # #  # #  # #
## ## ##### #  ## ##
#  # # # #  ##     #
##         #   #P# #
# # # # # # T#  #  #
# ##   #   ## P## ##
#  # # # # # #   # #
##P  ##  # # # #   #
###P#   #  # ## # ##
##   # # #       ###
#  #S# #   # ## # ##
# # # #  ###   #  P#
# #     #    #   # #
####################
