###                 #########
#   ###################   #T#
# ####                # # # #
# ################### # # # #
#                     # # # #
##################### # # # #
#   ##                # # # #
# # ## ### ## ######### # # #
# #    #   ##B#         # # #
# # ## ################ # # #
### ##             #### # # #
### ############## ## # # # #
###        C    ##    # # # #
###### ######## ####### # # #
###### ####    c        #   #
A      ######################