#####################
#S    #       #     #
### # ##### # # ### #
#   #     # # #   # #
# ##### # ### ### # #
#     # #     #   # #
##### # ####### ### #
#   # #   #   #     #
# # ### ### # ##### #
# #     #   #     # #
# ### ### ####### # #
#   #   #         #E#
#####################
