####################
# #   # # #      c #
#   #      ### ###c#
##C#  ## # # c #   #
# # # # #   # #  # #
#   # #T  #    # # #
#B#    # #  # #  # #
## ## ##### #  ## ##
#  # # # #  ##     #
##         #   #C# #
# # # # # # T#  #  #
# ##   #   ## c## ##
#  # # # # # #   # #
##c  ##  # # # #   #
###c#   #  # ## # ##
##   # # #       ###
#  #A# #   # ## # ##
# # # #  ###   #  C#
# #     #    #   # #
####################
