#####################
#A    #       #     #
### # ##### # # ### #
#   #     # # #   # #
# ##### # ### ### # #
#     # #     #   # #
##### # ####### ### #
#   # #   #   #     #
# # ### ### # ##### #
# #     #   #     # #
# ### ### ####### # #
#   #   #         #B#
#####################
