########
#A     #
# #### #
# #    #
# # ## #
# #    #
#     B#
########
